110001001101101000,10141,1291,1507,1524,116,106,4544
100100000111111101,7422,4044,3990,3013,347,323,11717
100011100000001111,611,5511,5123,4438,600,514,16186
100111100000110001,10585,1263,1153,1030,109,94,3649
010001110001101010,4291,1970,1793,1846,188,186,5983
111010001100100010,10174,1358,1236,1126,119,111,3950
111011100000100010,9847,1307,1435,1164,126,110,4142
111001100101001101,6674,1961,1808,1596,168,155,5688
100111011101111000,11808,1310,1318,940,113,97,3778
110001110001100000,7893,1380,1181,1088,113,106,3868
111110001111110000,13861,1236,1223,1023,106,90,3678
011011101010110011,5597,1359,1414,1123,129,115,4140
000111101000111000,8150,1417,1350,1068,117,110,4062
001111001001101011,6676,1707,1674,1211,160,136,4888
111101101010100000,11392,1508,1297,982,114,94,3995
011111101100101011,9148,1345,1472,1400,132,143,4492
110100001111111111,2043,51082,45010,41077,4127,4027,145323
000111010111011111,978,8800,8291,7212,913,844,26060
110101101001110000,11105,1256,1479,1097,105,91,4028
100011111011100100,5500,1574,1570,1372,148,134,4798
100111100000100010,9718,1528,1334,1134,113,118,4227
001111110101110010,7844,1436,1326,1148,122,113,4145
111111101000111010,13408,1348,1394,1057,103,92,3994
111101101010100011,10866,1514,1508,1092,123,110,4347
011001001011010001,4193,2305,2345,2035,231,181,7097
100110001101110000,10976,1399,1217,1095,121,104,3936
000001111110100010,5380,2139,2139,1807,245,205,6535
101001010110000000,7818,1930,1792,1599,176,178,5675
101101011010111110,2903,6524,6439,5382,684,617,19646
100111011010101001,10062,1461,1284,1028,119,109,4001
011011111011011011,4565,1973,1662,1406,236,217,5494
100101101010100010,7682,1667,1320,1149,137,110,4383
100110001000100000,8846,1591,1185,1244,144,115,4279
111011101101100000,11283,1330,1314,1016,113,102,3875
100111000000100010,9697,1451,1492,1227,116,118,4404
110110001001111001,12162,1224,1131,1151,110,101,3717
010011100101001111,644,6347,5954,5092,632,574,18599
111101001010111010,12281,1174,1240,1167,122,91,3794
001111101100100011,6305,1645,1604,1386,167,161,4963
101001000011011111,933,6169,5821,5027,672,577,18266
010000101000000001,1968,3617,3342,2763,352,335,10409
000010011010111111,241,22294,21183,17715,2190,2124,65506
000111101001011010,5892,2696,2155,1672,253,209,6985
111011000000110001,10570,1290,1178,953,109,94,3624
010111101101110011,8407,1549,1442,1117,129,111,4348
110101101010100000,10326,1262,1315,1038,105,103,3823
110001001101000000,8111,1579,1543,1229,147,130,4628
100101100010110000,8808,1295,1337,1088,115,105,3940
100111100001100000,9682,1745,1431,1206,147,125,4654
111001010110001101,6944,2254,1851,1544,179,176,6004
101001001001011111,794,5901,5668,4836,614,546,17565
101101000001101000,9585,1301,1245,1104,104,107,3861
111011001001000011,8034,1580,1419,1091,137,136,4363
101011101010110001,8623,1188,1239,1078,110,107,3722
110101000001101000,10778,1300,1175,991,103,105,3674
111011001010100000,10148,1381,1154,1125,109,95,3864
111100001001100000,10777,1247,1339,1136,97,110,3929
111010100011110000,10962,1440,1475,1125,116,95,4251
101111110111100000,11831,1430,1596,1106,103,108,4343
011011011011011011,4689,1974,1800,1541,184,161,5660
111111001001100000,12602,1490,1165,1070,105,105,3935
100111011110110000,11291,1471,1202,1077,104,108,3962
011001001011110001,6186,1664,1681,1325,162,139,4971
011011110000100011,4802,1784,1395,1274,162,154,4769
100010110001101000,6563,1685,1272,1241,121,130,4449
100110110001101000,9605,1458,1288,1033,126,105,4010
100111101010110000,10676,1245,1234,1042,105,102,3728
110110001101111001,12841,1194,1226,1019,107,101,3647
111001110001010111,1217,5449,5219,4272,602,556,16098
100111000011110000,10629,1276,1180,1159,107,106,3828
011111110001100011,8276,1429,1642,1563,165,142,4941
000111011001001011,5208,3455,3366,3137,328,320,10606
010101110000011011,4534,2024,1851,1492,215,182,5764
110110001101110000,12327,1273,1256,1030,113,88,3760
011110001101111011,9254,1365,1337,1047,117,110,3976
110111100000100010,11581,1323,1308,1127,114,95,3967
100011100000100010,6024,1444,1667,1391,120,122,4744
110110101101110000,12426,1227,1351,984,107,95,3764
101100001101110000,10705,1240,1283,1072,110,97,3802
011111101000111011,9976,1333,1255,1135,114,105,3942
000001010110001011,3302,3820,3620,3187,396,346,11369
011011101010100011,5087,1735,1478,1445,146,140,4944
100111011110101001,10874,1412,1403,1113,118,103,4149
001101000011101001,6077,1618,1644,1260,170,134,4826
010111101001100011,6834,1576,1499,1221,153,140,4589
100111011101100000,10087,1695,1328,1191,123,118,4455
101101101100100000,9944,1400,1219,1171,116,102,4008
100111101010110001,10590,1214,1240,1017,100,105,3676
101101101010100000,9317,1513,1489,1307,125,114,4548
100101110111110110,3604,6557,6273,5311,661,604,19406
001011011000100011,3436,2515,1846,1819,201,183,6564
011111110000111011,9797,1250,1209,1072,108,102,3741
011111101101110011,9660,1449,1349,1053,109,114,4074
110001110000110000,8231,1321,1237,1073,117,103,3851
011111110101100011,8620,1575,1458,1271,150,126,4580
100001100000100010,5757,1629,1781,1434,152,122,5118
111011000111100101,8840,2126,2013,1785,186,174,6284
100011011000100000,6577,1545,1419,1158,138,119,4379
101111100100000000,10084,2100,1615,1500,171,177,5563
110110101010100000,10747,1241,1464,1227,109,115,4156
110110001101111000,12944,1154,1399,1203,126,109,3991
111011101010101010,10350,1461,1189,1155,103,98,4006
100111100101111001,11639,1226,1160,1118,102,94,3700
011111110000010011,7209,2376,2175,1756,189,187,6683
111111100011100100,12009,1544,1824,1576,162,172,5278
100111111001001001,8910,1764,1946,1588,185,178,5661
110001110111101000,11303,1313,1378,998,112,101,3902
111101100000100000,11115,1281,1096,1047,107,103,3634
100100010000011101,3712,2164,2671,2200,233,240,7508
100111101010111000,11143,1340,1211,1031,123,115,3820
100101000011101000,8593,1387,1312,1171,122,97,4089
000001000001101110,1056,4189,4087,3229,409,325,12239
100101110111010110,2974,4839,4591,4062,501,434,14427
111011101010100000,10039,1265,1298,1049,115,101,3828
111111100100001001,12235,1557,1428,1237,136,125,4483
111111001101100000,13074,1295,1340,1101,113,104,3953
101101001010111000,11045,1276,1033,1025,101,89,3524
111001010110001001,9533,1568,1569,1198,131,119,4585
100010111101000000,6258,2202,2141,1858,221,206,6628
111011101101110000,11974,1687,1145,1393,149,142,4516
000001100111010001,5783,4089,3984,3067,504,478,12122
111111110111100000,13423,1324,1321,1286,105,107,4143
110111101100000110,3107,5920,5585,4705,597,511,17318
111100001101100000,11330,1549,1191,1276,137,92,4245
100110001001111001,10350,1230,1108,1012,105,98,3553
100111101001111000,11289,1230,1134,1037,97,96,3594
111001101100100000,10181,1343,1135,1107,121,118,3824
100111011001001001,8936,2065,2213,1387,191,197,6053
111011000001100010,9701,1426,1229,1178,112,101,4046
010111101100110011,8043,1520,1206,1277,118,126,4247
111011000100100010,10534,1450,1241,1109,116,95,4011
010111110000011011,6407,1807,1884,1518,177,186,5572
100010101011101000,7342,1617,1345,1089,132,124,4307
100110001001000000,7492,2066,1798,1871,232,204,6171
110001001010101000,8898,1379,1306,1113,110,99,4007
001111101000111010,8277,1681,1252,1183,158,123,4397
011111110101110011,9608,1523,1262,1055,106,98,4044
111010001101100000,10572,1424,1416,1113,118,101,4172
110001100000100010,7217,1444,1457,1238,145,113,4397
100010110001001000,4892,1805,1731,1612,191,189,5528
111001110000110111,983,9297,8681,7324,946,884,27132
100001000011101000,7126,1500,1528,1221,116,124,4489
000001100111110001,7898,1951,2340,1469,214,195,6169
110001001001101000,8180,1413,1240,1088,104,99,3944
011011100100001110,1346,4197,4108,3583,405,369,12662
111111101000100000,12510,1385,1187,1083,117,104,3876
100011100010100010,6275,1431,1653,1289,120,112,4605
000110001101111011,6983,1591,1440,1442,120,139,4732
101101001010110001,10146,1252,1128,1007,113,102,3602
101101001101000000,8962,1632,1855,1634,196,194,5511
110110001111110000,12985,1446,1153,1109,116,92,3916
100110001001111000,10294,1526,1451,1058,110,104,4249
111010001101111001,11654,1425,1384,1077,114,107,4107
100001001001100000,5868,1677,1511,1329,139,117,4773
110001101100100000,9395,1342,1363,1064,123,108,4000
111101100000100010,11022,1194,1228,1062,120,104,3708
100110010001101000,9395,1323,1242,1040,110,106,3821
001111100100001011,5656,2771,3172,2745,335,361,9384
111011001101110000,12050,1892,1666,1595,142,165,5460
110111011010111000,13065,1275,1190,1085,109,89,3748
000111110101110010,7286,1486,1234,1361,131,123,4335
110110001100111000,12632,1280,1095,1100,108,94,3677
111011011011100100,9236,1719,1630,1224,167,142,4882
111011000000100010,9808,1225,1290,1059,115,92,3781
000111101000111010,7662,1388,1200,1095,138,106,3927
000001000101111110,1815,6551,6297,5414,716,667,19645
101011101010101000,8382,1444,1263,1006,127,106,3946
011011101000111010,6605,1330,1239,1260,127,106,4062
100110001100100000,9152,1313,1216,1287,119,107,4042
011111110111010111,1411,10728,10619,9025,1093,1026,32491
101111011101111001,12298,1191,1133,987,104,90,3505
000111101100111010,8007,1499,1317,1143,120,114,4193
001111110000111011,7868,1527,1273,1089,121,105,4115
010111110101111011,8728,1306,1437,1272,128,108,4251
100010000010000101,2905,4283,4094,3269,422,400,12468
100111011001111001,11080,1370,1204,982,115,106,3777
001111110000111010,8144,1404,1525,1245,114,111,4399
100110001010111001,10692,1155,1166,1088,109,88,3606
110101101001100000,10121,1345,1207,1251,120,97,4020
100110010000111000,10368,1206,1143,1077,105,99,3630
100111100000110000,10635,1144,1262,1047,110,94,3657
111111101111100100,12691,1388,1260,1144,142,122,4056
101011101010100010,7384,1675,1598,1331,135,145,4884
110001000011101000,9405,1221,1392,1189,116,118,4036
110111000011110000,12635,1107,1328,947,111,92,3585
001101001101000011,4003,4110,3427,3278,423,381,11619
100101100000100010,7579,1368,1383,1195,124,117,4187
011010000001101010,5383,1764,1443,1684,155,123,5169
111011001001000000,8261,1544,1460,1126,137,144,4411
111100001000100010,10581,1276,1166,1166,106,107,3821
110001001111101000,11095,1556,1334,1173,115,114,4292
110001001001100000,8202,1463,1203,1118,104,100,3988
101101000011101000,10090,1521,1223,1067,109,110,4030
000111110001100011,5832,2005,1805,1513,195,178,5696
100111011101111001,11528,1344,1253,984,109,94,3784
010001111101000010,3830,3697,3414,2657,338,284,10390
100110001101111001,11216,1200,1149,984,105,101,3539
010110001101111011,7839,1429,1530,1119,109,120,4307
111111110111100100,12663,1661,1645,1283,154,109,4852
